dag!			goddag! 
de basiswoorden		grundordförråd
het woord			ord
de begroeting		hälsning

1
invullen (vul in)		fylla i
Wat hoort bij elkaar?		Vad hör ihop?
wat			vad
horen bij			höra till
kiezen (kies)			välja
elk, elke			varje
het plaatje			bild, illustration
juist			korrekt, riktig
goedemorgen!		god morgon!
goedemiddag!		god eftermiddag!
goedenavond!		god kväll!

2
de aandacht voor                 		uppmärksamhet för
kennismaken			lära känna (träffa)
zich voorstellen		presentera sig själv
luisteren (luister)		lyssna
de foto			foto
het gesprek			samtal			
in het ziekenhuis		på sjukhuset
op een camping		på en campingplats
op kantoor (het kantoor) 		på kontoret
bij/op de Spaanse les		på spanskkursen

3
de dialoog			dialog
ik ben (zijn)			jag är (vara)
hallo			hej
Je komt zeker uit België.		Du kommer säkert från Belgien.
komen			komma
je (obetonad)			du
ja			ja
dat klopt			det stämmer
kloppen			stämma
En waar kom jij vandaan?		Och varifrån kommer du?
waarvandaan; waar ... vandaan	varifrån
geboren			född
het dorpje			liten by
vlak bij			nära (ngt)
maar			men
nu			nu
wonen (woon)		bo
jij (betonad)			du
jij/je bent			du är
u (sg. och pl.)	 (U)		ni, Ni
nieuw, nieuwe		ny
de collega			kollega, arbetskamrat
het zuiden			södern
nee			nej
dat is			det(ta) är
Oostenrijk			Österrike
zitten (zit)			sitta
hier			här
al			redan
iemand			någon
mevrouw			fru (tilltalstitel)
de stoel			stol
nog			ännu
vrij			ledig
dank u			tack så mycket
prettig met u kennis te maken	angenämt att träffa Er
ook			också

4
opschrijven (schrijf op)		skriva upp
de naam			namn
hij			han
zij (betonad), ze (obetonad)	hon 

5
gebruiken (gebruik)		använda
de uitdrukking		uttryck
de vraag			fråga
de herkomst			ursprung, härkomst
informeel			informell
formeel			formell

6
stel uzelf voor		presentera Er  (själv)
zich[zelf] voorstellen		presentera sig (själv)
aan			(här) till, åt
ander, andere		annat, annat, andra
de cursist, de cursiste		(manlig, kvinlig) kursdeltagare
opletten (let op)		observera

7
vertellen aan (vertel)		berätta
de klas			klass, grupp
dit			detta

8
de stad (pl. steden)		stad
de Nederlander		nederländare, holländare
daar			där
gaan			gå, fara
de Duitser			tysk
Duitsland			Tyskland
de Nederlandse		nederländska, holländska

9
de tekst			text
tot ziens!			vi ses!

10
het papiertje			papperslapp
de woonplaats		hemort
fictief			fiktiv
geven (geef)			ge
de docent			lärare (vid högskola/universitet, på kurs)

12
het stapje (de stap)		litet steg (steg)
verder			vidare
het alfabet			alfabet

13
nog een keer			en gång till
de keer			gång
welk, welke			vilken, vilket, vilka
de letter			bokstav
anders			annorlunda
uw			er, Er
de taal			språk
nazeggen (zeg na)		upprepa efter någon

14
kunnen (kunt u)		kunna
deze			dessa
de afkorting			förkortning
uitspreken			uttala
de E.U. = de Europese Unie	Europeiska Unionen
het I.Q. 			IQ
de VVV			turistbyrå
de KLM			KLM; nederländskt flygbolag
de G.G.D. (Gemeentelijke 		kommunala hälsovården
   geneeskundige dienst)	   
de N.O.S. 			Nederländernas tv och radio (stiftelse)
a.u.b.			var så god(a) / var snäll(a)
de ANWB			organisation för befrämjande av [bil- och 			    cykel]turism
het KNMI			meteorologiska institutet
kennen (kent u)		känna

15
spellen			stava
vragen naar (vraag naar)		fråga efter
de medecursist, -cursiste		(manlig, kvinlig) kurskamrat
zijn			hans
haar			hennes
is 			är (3 sg.)
hoe			hur
heten (heet)			heta
Hoe heet je?			Vad heter du?

16
liggen (het ligt)		ligga, befinna sig
het land			land
Albanië			Albanien
België			Belgien
Bosnië			Bosnien
Bulgarije			Bulgarien
Cyprus			Cypern
Denemarken			Danmark
Duitsland			Tyskland
Estland			Estland
Finland			Finland
Frankrijk			Frankrike
Griekenland			Grekland
Hongarij			Ungern
Ierland			Irland
Italië			Italien
Kosovo			Kosovo
Kroatië			Kroatien
Letland			Lettland
Luxemburg			Luxemburg
Macedonië			Makedonien
Montenegro			Montenegro
Nederland			Nederländerna, Holland
Noorwegen			Norge
[de] Oekraïne		Ukraina
Polen			Polen
Portugal			Portugal
Roemenië			Rumänien
Rusland			Ryssland
Servië			Serbien
Slovenië			Slovenien
Slowakije			Slovakien
Spanje			Spanien
Tsjechië			Tjeckien
Turkije			Turkiet
het Verenigd Koninkrijk		Förenade Kungariket
Wit-Rusland			Vitryssland
Zweden			Sverige
Zwitserland			Schweiz	

17
omcirkelen			ringa in

S
de samenvatting		sammanfattning
de grammatica		grammatik
de vorm			form
de nadruk			eftertryck
vorm met nadruk		betonad form

